111111111111111111111
100P010000C000C000001
1111C1000000000000001
100000000000000000001
100000000000000000001
100000000000000000001
100000000000000000001
100000000000000000001
100000000000000000001
100000000000000000001
1000000000000CEC00001
111111111111111111111
